#########################
#                       #
#                       #
#      #           #    #
#      #           #    #
#                       #
#            #          #
#            #          #
#                       #
#                       #
#                       #
#            #          #
#            #          #
#                       #
#                       #
#      #          #     #
#      #          #     #
#                       #
#                       #
#########################
